NO textures/NO.xpm
SO textures/SO.xpm
EA textures/EA.xpm
WE textures/WE.xpm

C 255,255,255
F 255,255,255

1111111111111111111111111
1011000001110000000000001
100000000011000001110111111111111
11110111111111011100000010S01
11110111111111011101010010001
110000001101010111000000P0001
10001000000000001100000010001
10000000000000001101010010001
11000001110101011111011110N01111
11110111 1110101 101111010001
11111111 1111111 111111111111
