C 0,30,0
F 0,0,30

NO textures/O.xpm42
SO textures/O.xpm42
EA textures/O.xpm42
WE textures/E.xpm42

1111111111111111111111111
1011000001110000000000001
10000000001100000111P111111111111
11110111111111011100000010001
1111011111111101110P0P0010001
11000000110101011100000000001
10001000000000001100000010001
10000000000000001101010010001
11000001110101011111011110N01111
11110111 1110101 101111010001
11111111 1111111 1111111	11111
