F 220,100,0
C 255,0,255

NO      ./textures/NO.xpm42
SO    ./textures/SO.xpm42
EA              ./textures/EA.xpm42
WE ./textures/WE.xpm42

11111111111111111111111111
10000000000000000000100001
10000000000000000000100001
1000000000000000E000100001
10000000000000000000100001
10000000010000000000000001
10000000000000000000000001
10000000000000000000000001
11111111111111111111111111
